1111111111111
1P0011E00C001
1111111111111
